1111111
110P0C1
1000001
1000001
100C001
10000E1
1111111