1111111
1100C01
11E00P1
1111111
