1111111111111111111111111111
110001111110000C011111110001
11E00P0000000000000000000001
1111111101000000000000000111
1100C00011100001111111111111
1C0C0C1C000000000000000000C1
1111111111111111111111111111