11111111
100000E1
100C0001
100CC001
100P0001
10000001
11111111