111111111111111
1E00P0000000001
1C0C11111111111
111111111111111