1111111
110C0C1
10E00P1

110C0C1
1111111