1111111
110C0C1
1E000P1
110C0C1
1111111