11111111
1P1C11E1
10001001
11000011
1C0110C1
11111111