11111111
1P1C11E1
10000001
11111011
1C0000C1
11111111