11111111111111111111
110001000C0111110001
11E00P00000000000001
11111110000000000111
1100C000110011111111
1C0C0C1C0000000000C1
11111111111111111111